XXXXXXXXXXXXXXX
X             X
X XXXXX XXXXX X
X X   X X   X X
X X X X X X X X
X   X   X X   X
XXX XXXXX XXXXX
X             X
X XXXXX XXXXX X
XXXXXXXXXXXXXXX
